# # # # # # # #
# S . . # . . #
# . . . # . . #
# . . . . . . #
# # # # # # # #

# # # # # # # #
# . . . . . . #
# . # # # # # #
# . . . . . . #
# # # # # # # #

# # # # # # # #
# . . . # . E #
# . . . # . . #
# . . . . . . #
# # # # # # # #